1100000000011
0100111000000
0000011100011
1100000010000
0000111000011
1100000000011